گوشی شیایومی : گوشی شیائومی 
اسباب بازی : اسباب‌بازی 
ساعت مچی مردانه : ساعت‌مچی مردانه 
ساعت مچی : ساعت‌مچی 
ایرپاد : ایر پاد 
ساعت هوشمند شیایومی : ساعت هوشمند شیائومی 
اسباب بازی دخترانه : اسباب‌بازی دخترانه 
عینک افتابی : عینک‌آفتابی 
پلی استیشن 4 : پلی‌استیشن 4 
چراغ قوه : چراغ‌قوه 
پلی استیشن 2 : پلی‌استیشن 2 
بی سیم : بی‌سیم 
پمپ اب : پمپ آب 
چرخ خیاطی : چرخ‌خیاطی 
ریش تراش : ریش‌تراش 
فرفره های انفجاری : فرفره‌های انفجاری 
ساعت مچی زنانه : ساعت‌مچی زنانه 
پلی استیشن : پلی‌استیشن 
کاندوم تاخیری : کاندوم تأخیری 
چرخ گوشت : چرخ‌گوشت 
پاوربانک : پاور بانک 
شیایومی : شیائومی 
پاور بانک شیایومی : پاور بانک شیائومی 
فوتبال دستی : فوتبال‌دستی 
لوازم ارایشی : لوازم آرایشی 
تخته نرد : تخته‌نرد 
اسباب بازی پسرانه : اسباب‌بازی پسرانه 
بیسیم : بی‌سیم 
گوشی شیایومی پوکو : گوشی شیائومی پوکو 
مولتی متر : مولتی‌متر 
چراغ مطالعه : چراغ‌مطالعه 
کولر ابی : کولر آبی 
پلی استیشن 3 : پلی‌استیشن 3 
موبایل شیایومی : موبایل شیائومی 
توالت فرنگی : توالت‌فرنگی 
شیر الات : شیرآلات 
اسباب بازی ماشین : اسباب‌بازی ماشین 
قمقمه اب : قمقمه آب 
سه چرخه کودک : سه‌چرخه کودک 
ایرپاد شیایومی : ایر پاد شیائومی 
ایرپاد پرو : ایر پاد پرو 
گوشی شیایومی نوت 9 : گوشی شیائومی نوت 9 
گوشی شیامی : گوشی شیائومی 
کرم پودر : کرم‌پودر 
ماسک ورقه ای : ماسک ورقه‌ای 
تخت خواب یک نفره : تخت خواب یک‌نفره 
مبل چستر : مبل چس‌تر 
سه چرخه : سه‌چرخه 
اب میوه گیری : آبمیوه‌گیری 
اسپرسوساز : اسپرسو ساز 
دچرخه : دوچرخه 
دوچرخه 26 دنده ای : دوچرخه 26 دنده‌ای 
میوه خشک کن : میوه خشک‌کن 
ابمیوه گیری : آبمیوه‌گیری 
شیامی : شیائومی 
اسباب بازی  : اسباب‌بازی  
ریش تراش فیلیپس : ریش‌تراش فیلیپس 
لباسشویی ال جی : لباس‌شویی ال جی 
هندزفری بلوتوثی شیایومی : هندزفری بلوتوثی شیائومی 
پنجه بوکس : پنجه‌بوکس 
ایپد : آیپد 
شیایومی نوت 8 : شیائومی نوت 8 
خط زن : خط‌زن 
ساعت مچی دخترانه : ساعت‌مچی دخترانه 
دستکش دروازه بانی : دستکش دروازه‌بانی 
فلاکس : فلاسک 
ارپاد : ایر پاد 
لوستر اشپزخانه : لوستر آشپزخانه 
دراور : درآور 
غذاساز : غذا ساز 
اباژور ایستاده : آباژور ایستاده 
وای فای : وای‌فای 
پیچ گوشتی : پیچ‌گوشتی 
کیسه خواب : کیسه‌خواب 
ماشین لباسشویی ال جی : ماشین لباس‌شویی ال جی 
اسلایم خامه ای : اسلایم خامه‌ای 
اینه کنسول : آینه کنسول 
هدفن : هدفون 
میز ناهار خوری : میز ناهارخوری 
مداد رنگی فابر کاستل : مداد رنگی فابرکاستل 
تبلت شیایومی : تبلت شیائومی 
بستنی ساز : بستنی‌ساز 
لب تاب لنوو : لپ‌تاپ لنوو 
چرخ خیاطی کاچیران : چرخ‌خیاطی کاچیران 
چرخ گوشت پارس خزر : چرخ‌گوشت پارس خزر 
قاشق چنگال : قاشق‌چنگال 
نوت۱۱ : نوت ۱۱ 
نوت11 : نوت 11 
تلوزیون ال جی : تلویزیون ال جی 
پهباد دوربین دار : پهباد دوربین‌دار 
پلی استیشن ۲ : پلی‌استیشن ۲ 
پشه بند : پشه‌بند 
کاندم خاردار : کاندوم خاردار 
حوله تن پوش : حوله تن‌پوش 
دستگاه جوجه کشی : دستگاه جوجه‌کشی 
ساعت مچی هوشمند : ساعت‌مچی هوشمند 
پلی استیشن ۴ : پلی‌استیشن ۴ 
ایفون 13 پرومکس : ایفون 13 پرو مکس 
تلفن بی سیم : تلفن بی‌سیم 
کولر اسپلیت : کولر اسپیلت 
لوازم التحریر : لوازم‌التحریر 
شیرالات : شیرآلات 
کره بادام زمینی : کره بادام‌زمینی 
گوشی موبایل شیایومی : گوشی موبایل شیائومی 
تلوزیون سامسونگ : تلویزیون سامسونگ 
سیم چین : سیم‌چین 
عینک طبی : عینک‌طبی 
چراغ خواب : چراغ‌خواب 
ساعت بچه گانه : ساعت بچه‌گانه 
تصفیه اب خانگی : تصفیه آب خانگی 
میز چرخ خیاطی : میز چرخ‌خیاطی 
نیم تنه : نیم‌تنه 
ماشین اسباب بازی : ماشین اسباب‌بازی 
متور سیکلت : موتور سیکلت 
نوت11 پرو : نوت 11 پرو 
تی شرت مردانه : تیشرت مردانه 
ایرپاد  : ایر پاد  
هنذفری : هندزفری 
گوشی شیایومی ردمی : گوشی شیائومی ردمی 
کاور گوشی شیایومی : کاور گوشی شیائومی 
ظبط ماشین : ضبط ماشین 
عینک دودی : عینک‌دودی 
کیف مدرسه دخترونه : کیف مدرسه دخترانه 
پلی استیشن ۳ : پلی‌استیشن ۳ 
عینک افتابی دخترانه : عینک‌آفتابی دخترانه 
اکواریوم : آکواریوم 
قرص تاخیری اقایان : قرص تأخیری آقایان 
اره برقی : اره‌برقی 
کمک فنر پراید : کمک‌فنر پراید 
هنزفری : هندزفری 
هدفون گربه ای : هدفون گربه‌ای 
ساندبار : ساند بار 
کفش پیاده روی : کفش پیاده‌روی 
مکمل بدنسازی : مکمل بدن‌سازی 
پروتیین وی : پروتئین وی 
تخم مرغ : تخم‌مرغ 
کیسه اب گرم : کیسه آب گرم 
سیم کارت : سیم‌کارت 
هتفون : هدفون 
لپتاپ گیمینگ : لپ‌تاپ گیمینگ 
موس بی سیم : موس بی‌سیم 
ساعت مچی  : ساعت‌مچی  
چراغ قوه پلیسی : چراغ‌قوه پلیسی 
سرویس قاشق چنگال : سرویس قاشق‌چنگال 
ساعت دیجیتال شیایومی : ساعت دیجیتال شیائومی 
ترازو اشپزخانه : ترازو آشپزخانه 
پیک نیک : پیک‌نیک 
چرخ خیاطی مارشال : چرخ‌خیاطی مارشال 
لباس بچه گانه : لباس بچه‌گانه 
سردوز : سر دوش 
چراغ قوه پیشانی : چراغ‌قوه پیشانی 
کارتخوان سیار : کارت‌خوان سیار 
کارت خوان : کارت‌خوان 
اسپرسوساز مباشی : اسپرسو ساز مباشی 
اینورتر جوشکاری : این‌ورتر جوشکاری 
کرم پودر لاکچری کوین : کرم‌پودر لاکچری کوین 
سم پاش : سم‌پاش 
کپسول اتش نشانی : کپسول آتش‌نشانی 
ارمیچر : آرمیچر 
زیر انداز : زیرانداز 
نینتندو سوییچ : نینتندو سوئیچ 
سبد پیک نیک : سبد پیک‌نیک 
استند لوازم ارایشی : استند لوازم آرایشی 
ارکوپال : آرکوپال 
شمشیر اسباب بازی : شمشیر اسباب‌بازی 
هندزفری شیایومی : هندزفری شیائومی 
براش ارایشی : براش آرایشی 
روغن زیتون : روغن‌زیتون 
لوستر اویز : لوستر آویز 
دچرخه 20 : دوچرخه 20 
شیامی نوت 8 : شیائومی نوت 8 
اتاری : آتاری 
لبتاب لنوو : لپ‌تاپ لنوو 
کارت خوان سیار : کارت‌خوان سیار 
مچ بند هوشمند : مچ‌بند هوشمند 
اینورتر : این‌ورتر 
تخت یک نفره : تخت یک‌نفره 
کاغذ دیواری سه بعدی : کاغذ دیواری سه‌بعدی 
آبمیوه گیری : آبمیوه‌گیری 
اسپری تاخیری ویگا : اسپری تأخیری ویگا 
گارد گوشی شیایومی : گارد گوشی شیائومی 
کراتین بدنسازی : کراتین بدن‌سازی 
ژل شستشوی صورت : ژل شستشو صورت 
جا کفشی چوبی : جاکفشی چوبی 
اجاق گاز طرح فر : اجاق‌گاز طرح فر 
اچار فرانسه : آچار فرانسه 
چاقو اشپزخانه : چاقو آشپزخانه 
گوشی شیایومی نوت : گوشی شیائومی نوت 
اتومو : اتو مو 
ماشین خط زن : ماشین خط‌زن 
پرژکتور : پروژکتور 
دستمال کاغذی : دستمال‌کاغذی 
رب گوجه فرنگی : رب گوجه‌فرنگی 
مودم سیم کارتی : مودم سیم‌کارتی 
اباژور : آباژور 
تبلت دانش اموزی : تبلت دانش‌آموزی 
میز تلوزیون : میز تلویزیون 
ضد افتاب : ضد آفتاب 
مولتی ویتامین : مولتی‌ویتامین 
ابمیوه گیری بوش : آبمیوه گیری بوش 
ژل روان کننده : ژل روان‌کننده 
لباس بچه گانه دخترانه : لباس بچه‌گانه دخترانه 
پاوربانک شیایومی : پاور بانک شیائومی 
پلستیشن 4 : پلی استیشن 4 
قیمت گوشی شیایومی : قیمت گوشی شیائومی 
راکت پینگ پنگ : راکت پینگ‌پنگ 
کامپیوتر همه کاره : کامپیوتر همه‌کاره 
لوپ : توپ 
روغن مایع : روغن‌مایع 
لامپ کم مصرف : لامپ کم‌مصرف 
آیفون ۱۳ پرومکس : آیفون ۱۳ پرو مکس 
کلمن اب : کلمن آب 
شیایومی ردمی : شیائومی ردمی 
چرخ خیاطی  : چرخ‌خیاطی  
پکو x3 : پوکو x3 
هندزفری بلوتوث شیایومی : هندزفری بلوتوث شیائومی 
کیبورد بی سیم : کیبورد بی‌سیم 
ماسک ورقه ای صورت : ماسک ورقه‌ای صورت 
پاوربانک 20000 : پاور بانک 20000 
شیاومی : شیائومی 
سرویس ارکوپال : سرویس آرکوپال 
ادامس : آدامس 
امپلی فایر خودرو : آمپلی‌فایر خودرو 
لباس دختر کفشدوزکی : لباس دختر کفشدوزک 
شرت مردانه : شورت مردانه 
لب تاپ لنوو : لپ‌تاپ لنوو 
مولتی متر دیجیتال : مولتی‌متر دیجیتال 
وسایل تزیینی : وسایل تزئینی 
بانکه شیشه ای : بانکه شیشه‌ای 
سرخکن فیلیپس : سرخ‌کن فیلیپس 
انتن رومیزی : آنتن رومیزی 
وسایل ارایشی : وسایل آرایشی 
شیایومی نوت 11 پرو : شیائومی نوت 11 پرو 
وسایل اشپزخانه : وسایل آشپزخانه 
عینک آفتابی : عینک‌آفتابی 
مایع لباسشویی : مایع لباس‌شویی 
ابچکان رومیزی : آبچکان رومیزی 
میز پینگ پنگ : میز پینگ‌پنگ 
کره گیر : کره‌گیر 
تفنگ اب پاش : تفنگ آب‌پاش 
ساچمه تفنگ بادی : ساچمه تفنگ‌بادی 
ضد افتاب لافارر : ضد آفتاب لافارر 
یخچال فریزر اسنوا : یخچال‌فریزر اسنوا 
چاقو ضامن دار : چاقو ضامن‌دار 
گوشی شیامی نوت 9 : گوشی شیائومی نوت 9 
ایفون۱۱ : ایفون ۱۱ 
گوشی شیایومی نوت 11 پرو : گوشی شیائومی نوت 11 پرو 
ورق ام دی اف : ورق‌ام دی اف 
سه تار : سه‌تار 
کش بدنسازی : کش بدن‌سازی 
گردن بند : گردن‌بند 
ظبط پایونر : ضبط پایونیر 
ژل تاخیری : ژل تأخیری 
قوزبند طبی : قوز بند طبی 
هنگدرام : هنگ درام 
اجاق برقی : اجاق‌برقی 
تاخیری اقایان : تأخیری آقایان 
لوازم خانگی : لوازم‌خانگی 
ایفون ۱۳ پرومکس : ایفون ۱۳ پرو مکس 
کرم ضد افتاب : کرم ضد آفتاب 
جاروبرقی شیایومی : جاروبرقی شیائومی 
اهم متر : اهم‌متر 
ساعت مچی عقربه ای : ساعت مچی عقربه‌ای 
اسبابازی : اسباب‌بازی 
ابزار همه کاره : ابزار همه‌کاره 
پلستیشن 2 : پلی استیشن 2 
ناخن مصنوعی بچه گانه : ناخن مصنوعی بچه‌گانه 
سوتین ژله ای : سوتین ژله‌ای 
موزر المانی : موزر آلمانی 
فرفره های انفجاری  : فرفره‌های انفجاری  
تلوزیون سونی : تلویزیون سونی 
یخچال فریزر امرسان : یخچال‌فریزر امرسان 
ابگرمکن : آب گرمکن 
شلوار شیش جیب : شلوار شش جیب 
چراغ قوه اسمال سان : چراغ‌قوه اسمال سان 
اسباب بازی مرد عنکبوتی : اسباب‌بازی مرد عنکبوتی 
اهن ربا : آهن‌ربا 
چراغ قوه  : چراغ‌قوه  
اتوماتیک پمپ اب : اتوماتیک پمپ آب 
ایفون11 : ایفون 11 
مچ بند : مچ‌بند 
اجاق گاز صفحه : اجاق‌گاز صفحه 
ماسک صورت ورقه ای : ماسک صورت ورقه‌ای 
مداد رنگی اریا : مداد رنگی آریا 
ماشین بازی : ماشین‌بازی 
گوشی شیایومی  : گوشی شیائومی  
گوشی  سامسونگ : گوشی سامسونگ 
کهنه شور : کهنه‌شور 
پاسماوری سرامیکی : پا سماوری سرامیکی 
متور چهار چرخ : موتور چهار چرخ 
چای ساز میگل : چای‌ساز میگل 
گوشی شیایومی mi11 : گوشی شیائومی mi11 
بازی پلی استیشن 2 : بازی پلی‌استیشن 2 
آبگرمکن : آب گرمکن 
بطری شیشه ای : بطری شیشه‌ای 
وانت پیکان : وانت‌پیکان 
ابگرمکن برقی : آب گرمکن برقی 
البوم بی تی اس : آلبوم بی تی اس 
اسپلیت : اسپیلت 
هواپز فیلیپس : هوا پز فیلیپس 
خوشبو کننده ایفل : خوش‌بوکننده ایفل 
پلی استیشن  : پلی‌استیشن  
شیایومی نوت 10 پرو : شیائومی نوت 10 پرو 
میزتلویزیون : میز تلویزیون 
پمپ بنزین : پمپ‌بنزین 
اچار بکس : آچار بکس 
دوچرخه حرفه ای : دوچرخه حرفه‌ای 
تبل محرم : طبل محرم 
مینی لپ تاپ : مینی لپ‌تاپ 
ایرپاد هایلو : ایر پاد هایلو 
پستونک : پستانک 
شیایومی پوکو x3 : شیائومی پوکو x3 
گوپرو : گو پرو 
لب تاب hp : لپ‌تاپ hp 
گوشی پکو x3 : گوشی پوکو x3 
بادام هندی : بادام‌هندی 
میخ کوب : میخ‌کوب 
دوچرخه۲۰ : دوچرخه ۲۰ 
تابلو فرش دستبافت : تابلو فرش دستباف 
لب تاب گیمینگ : لپ‌تاپ گیمینگ 
گردن بند مردانه : گردن‌بند مردانه 
هنسفری بی سیم : هندزفری بی‌سیم 
هنذفری بی سیم : هندزفری بی‌سیم 
بادام زمینی : بادام‌زمینی 
اسباب بازی حیوانات : اسباب‌بازی حیوانات 
کنسول بازی قابل حمل : کنسول بازی قابل‌حمل 
ریش تراش  : ریش‌تراش  
ظبط خودرو : ضبط خودرو 
موتور هندا : موتور هوندا 
فارسی بر ماکیتا : فارسی‌بر ماکیتا 
کاور ایرپاد : کاور ایر پاد 
رورویک : روروئک 
گوشی شیامی  : گوشی شیائومی  
سایه بان : سایه‌بان 
میز ناهار خوری 6 : میز ناهارخوری 6 
سگ های نگهبان : سگ‌های نگهبان 
دستکش بدنسازی : دستکش بدن‌سازی 
گوشی شیاومی : گوشی شیائومی 
لبتاب اپل : لپ‌تاپ اپل 
لبتاب گیمینگ : لپ‌تاپ گیمینگ 
کلاه خود : کلاه‌خود 
ذره بین : ذره‌بین 
تفنگ آب پاش : تفنگ آب‌پاش 
ریلمی جی تی مستر : ریلمی جی تی مس‌تر 
اتو لوله کشی : اتو لوله‌کشی 
اره فارسی بر : اره فارسی‌بر 
ریش تراش پاناسونیک : ریش‌تراش پاناسونیک 
دوچرخه20 : دوچرخه 20 
میوه خوری : میوه‌خوری 
تفنگ بادی 4.5 : تفنگ‌بادی 4.5 
درب اتاق خواب : درب اتاق‌خواب 
دوچرخه مسابقه ای : دوچرخه مسابقه‌ای 
ماشین اصلاح خط زن : ماشین اصلاح خط‌زن 
ماکروویو ال جی : ماکروویو ال‌جی 
بشقاب ارکوپال : بشقاب آرکوپال 
بلک بری : بلک‌بری 
ابکش استیل : آبکش استیل 
یخچال فریزر سامسونگ : یخچال‌فریزر سامسونگ 
ارایشی : آرایشی 
پلستیشن 5 : پل استیشن 5 
کره گیر برقی : کره‌گیر برقی 
جاروبرقی ال جی : جاروبرقی ال‌جی 
لوازم التحریر فانتزی : لوازم‌التحریر فانتزی 
پرده اتاق خواب : پرده اتاق‌خواب 
تیر تفنگ بادی : تیر تفنگ‌بادی 
ریش تراش کیمی : ریش‌تراش کیمی 
کوشی شیامی : کوشی شیائومی 
اسیاب : آسیاب 
بستنی خوری : بستنی‌خوری 
ریش تراش موزر : ریش‌تراش موزر 
وکیوم اقایان : وکیوم آقایان 
مولتی متر کلمپی : مولتی‌متر کلمپی 
جعبه ابزار کامل : جعبه‌ابزار کامل 
ماشین ریش تراش فیلیپس : ماشین ریش‌تراش فیلیپس 
پلستیشن 3 : پل استیشن 3 
ادامس متری : آدامس متری 
لگو مرد اهنی : لگو مرد آهنی 
لپتاپ لنوو : لپ‌تاپ لنوو 
دندان مصنوعی : دندان‌مصنوعی 
گوشی  شیایومی : گوشی شیائومی 
ناخون مصنوعی : ناخن مصنوعی 
میخ کوب بادی : میخ‌کوب بادی 
نوت10 پرو : نوت 10 پرو 
گوشی پکو : گوشی پوکو 
فن خنک کننده : فن خنک‌کننده 
سشوار حرفه ای : سشوار حرفه‌ای 
برچسب تزیینی : برچسب تزئینی 
دسبند دخترانه : دستبند دخترانه 
لاک پشت : لاک‌پشت 
سبزی خردکن : سبزی‌خردکن 
خط کش : خط‌کش 
شلوار مردانه پارچه ای : شلوار مردانه پارچه‌ای 
پاور بانک شیایومی 20000 : پاور بانک شیائومی 20000 
اچار الن : آچار الن 
شکلات خوری : شکلات ناهارخوری 
هنسفری : هندزفری 
سرویس اشپزخانه : سرویس آشپزخانه 
لب تاب اپل : لپ‌تاپ اپل 
لپ تاپ اچ پی : لپ‌تاپ اچ پی 
نوت ۱۱پرو : نوت ۱۱ پرو 
جعبه ابزار فلزی : جعبه‌ابزار فلزی 
پمپ کولر ابی : پمپ کولر آبی 
ابمیوه گیری پارس خزر : آبمیوه گیری پارس خزر 
کیس گیمینگ اماده : کیس گیمینگ آماده 
شیایومی 11 تی پرو : شیائومی 11 تی پرو 
فرش اشپزخانه : فرش آشپزخانه 
اسبیکر : اسپیکر 
اغوشی نوزاد : آغوشی نوزاد 
اینه دکوراتیو : آینه دکوراتیو 
ماینکرافت : ماین کرفت 
تسبیح شاه مقصود : تسبیح شاه‌مقصود 
ساعت مچی بچه گانه : ساعت مچی بچه‌گانه 
کواد کوپتر دوربین دار : کواد کوپتر دوربین‌دار 
انتن تلویزیون : آنتن تلویزیون 
سیب زمینی : سیب‌زمینی 
کاندم خاردار بزرگ : کاندوم خاردار بزرگ 
نوت۱۰ : نوت ۱۰ 
چرخ گوشت صنعتی : چرخ‌گوشت صنعتی 
شیایومی 11 تی : شیائومی 11 تی 
تیشرت ادیداس : تیشرت آدیداس 
چمن زن : چمن‌زن 
یخچال فریزر الکترواستیل : یخچال‌فریزر الکترو استیل 
تیشرت استین بلند : تیشرت آستین‌بلند 
کیف لوازم ارایش : کیف لوازم‌آرایش 
لب تاب دل : لپ‌تاپ دل 
نوت 11پرو : نوت 11 پرو 
اسباب بازی ماشین کنترلی : اسباب‌بازی ماشین کنترلی 
کت شلوار مردانه : کت‌شلوار مردانه 
لرزه گیر لباسشویی : لرزه‌گیر لباس‌شویی 
ماشین لباس شویی : ماشین لباس‌شویی 
غذاساز فیلیپس : غذا ساز فیلیپس 
عمو پولدار : عمو پول‌دار 
اینورتر صبا : این‌ورتر صبا 
فوم شستشوی صورت : فوم شستشو صورت 
کلاغ پران : کلاغ‌پران 
قلمو : قلم‌مو 
رخت اویز استیل : رخت‌آویز استیل 
پتو یک نفره : پتو یک‌نفره 
کولر ابی 7000 : کولر آبی 7000 
اپلیدی : اپیلیدی 
چرخ گوشت  : چرخ‌گوشت  
ابمیوه گیری پاناسونیک : آبمیوه گیری پاناسونیک 
کرم پودر مک : کرم‌پودر مک 
جوجه کشی : جوجه‌کشی 
ابچکان : آبچکان 
ابمیوه گیر : آبمیوه گیر 
فرتوکار : فر توکار 
لوازم التحریر  : لوازم‌التحریر  
پرده زبرا اشپزخانه : پرده زبرا آشپزخانه 
شیرالات شودر : شیرآلات شودر 
پک لوازم ارایشی : پک لوازم آرایشی 
بی سیم اسباب بازی : بی‌سیم اسباب‌بازی 
دوربین عکاسی حرفه ای : دوربین عکاسی حرفه‌ای 
کفپوش سه بعدی : کفپوش سه‌بعدی 
کیف مدرسه بچه گانه : کیف مدرسه بچه‌گانه 
لپ تاب لنوو : لپ‌تاپ لنوو 
چای ساز تفال : چای‌ساز تفال 
لباس عروس بچه گانه : لباس عروس بچه‌گانه 
ال جی : ال‌جی 
مبایل سامسونگ : موبایل سامسونگ 
کلت ساچمه ای : کلت ساچمه‌ای 
آیفون۱۱ : آیفون ۱۱ 
ایرپاد لنوو : ایر پاد لنوو 
دلار امریکا : دلار آمریکا 
اویز گوشی : آویز گوشی 
ماشین ظرف شویی : ماشین ظرف‌شویی 
شکم بند لاغری : شکم‌بند لاغری 
اره مویی : اره‌مویی 
موتر سیکلت : موتور سیکلت 
گیفت کارت پلی استیشن : گیفت کارت پلی‌استیشن 
گلیم اشپزخانه : گلیم آشپزخانه 
لب تاپ hp : لپ‌تاپ hp 
گوشی یک میلیونی : گوشی یک‌میلیونی 
رینگ لایت پایه دار : رینگ لایت پایه‌دار 
گلاب گیر : گلاب‌گیر 
اجیل : آجیل 
چاقو همه کاره : چاقو همه‌کاره 
نوشت افزار : نوشت‌افزار 
گوشی شیامی پوکو : گوشی شیائومی پوکو 
مداد رنگی ام کیو : مداد رنگی‌ام کیو 
عرق گیر : عرق‌گیر 
تودری پراید : تو دری پراید 
مای بی بی : مای بی‌بی 
ماسک ورقه ای  : ماسک ورقه‌ای  
فرگاز : فر گاز 
کباب پز دادلیسان : کباب‌پز دادلیسان 
تفنگ ساچمه ای فلزی : تفنگ ساچمه‌ای فلزی 
میزناهارخوری 4نفره : میز ناهارخوری 4 نفره 
مولتی متر  : مولتی‌متر  
عینک سه بعدی : عینک سه‌بعدی 
شیایومی  : شیائومی  
ناخن گیر : ناخن‌گیر 
تی شرت زنانه : تیشرت زنانه 
یخچال فریزر دیپوینت : یخچال‌فریزر دیپوینت 
ایفون۱۲ : ایفون ۱۲ 
جا قاشقی : جاقاشقی 
قهوه فوری : قهوه‌فوری 
قلع کش : قلع‌کش 
ماهی اکواریوم : ماهی آکواریوم 
نوت۱۱پرو : نوت ۱۱ پرو 
رخت اویز : رخت‌آویز 
موتورشارژی : موتور شارژی 
تلوزیون جی پلاس : تلویزیون جی پلاس 
تیلر شخم زنی : تیلر شخم‌زنی 
لوازم ارایش : لوازم‌آرایش 
اپارتمان فروشی : آپارتمان فروشی 
عینک افتابی پلیس : عینک آفتابی پلیس 
پاوربانک  : پاور بانک  
تلفن بیسیم : تلفن بی‌سیم 
پروتین وی : پروتئین وی 
زیر انداز مسافرتی : زیرانداز مسافرتی 
گاز صفحه ای اخوان : گاز صفحه‌ای اخوان 
چاقو دنده ای : چاقو دنده‌ای 
شوکر پلیسی واقی : شوکر پلیسی واقعی 
برنج هاشمی درجه یک : برنج هاشمی درجه‌یک 
اجاق گاز مسافرتی : اجاق‌گاز مسافرتی 
کیف مدرسه ای : کیف مدرسه‌ای 
رو تختی یک نفره : رو تختی یک‌نفره 
آ۱۳ : آ ۱۳ 
میلگرد : میل‌گرد 
ارکوپال فرانسه : آرکوپال فرانسه 
کول پد لپ تاپ : کول پد لپ‌تاپ 
کوله پشتی دخترانه فانتزی : کوله‌پشتی دخترانه فانتزی 
پیکنیک : پیک‌نیک 
شیامی نوت 11 پرو : شیائومی نوت 11 پرو 
چراغ مطالعه فانتزی : چراغ‌مطالعه فانتزی 
شرت : شورت 
لوازم التحریر دخترانه : لوازم‌التحریر دخترانه 
ضدافتاب : ضدآفتاب 
تشک یک نفره : تشک یک‌نفره 
پرینتر سه کاره : پرینتر سه‌کاره 
گوشی اسباب بازی : گوشی اسباب‌بازی 
شکم بند : شکم‌بند 
توالت فرنگی سیار : توالت‌فرنگی سیار 
دوچرخه 24 دنده ای : دوچرخه 24 دنده‌ای 
ماوس بی سیم : ماوس بی‌سیم 
اسپرسوساز  : اسپرسو ساز  
کرم پودر دوسه : کرم‌پودر دوسه 
کیف لوازم ارایشی : کیف لوازم آرایشی 
باتری قلمی : باتری‌قلمی 
جعبه فرمان : جعبه‌فرمان 
کفش پاشنه بلند دخترانه : کفش پاشنه‌بلند دخترانه 
ایرپاد 2 : ایر پاد 2 
جاادویه : جا ادویه 
بیسیم  : بی‌سیم  
حشره کش : حشره‌کش 
توالت فرنگی کودک : توالت‌فرنگی کودک 
اکسیژن ساز : اکسیژن‌ساز 
بابلیس مو : بابیلیس مو 
کامیون اسباب بازی : کامیون اسباب‌بازی 
پاوربانک شیایومی 20000 : پاور بانک شیائومی 20000 
چراغ مطالعه  : چراغ‌مطالعه  
ساعت هوشمند بچه گانه : ساعت هوشمند بچه‌گانه 
نوت11s : نوت 11 s 
ایفون13 پرو : ایفون 13 پرو 
تخته سیاه : تخته‌سیاه 
موتور اسباب بازی : موتور اسباب‌بازی 
توالت فرنگی دیواری : توالت‌فرنگی دیواری 
‏ps۴ : ‌ps۴ 
لپتاپ hp : لپ‌تاپ hp 
صندلی ارایشگاه مردانه : صندلی آرایشگاه مردانه 
کفش بچه گانه پسرانه : کفش بچه‌گانه پسرانه 
کیف دستی : کیف‌دستی 
اچار لوله گیر : آچار لوله گیر 
لگو ادمک : لگو آدمک 
دوربین فیلم برداری : دوربین فیلم‌برداری 
ایرپد : ایر پاد 
عرق گیر انگشت : عرق‌گیر انگشت 
ایفون11 پرو : ایفون 11 پرو 
چرخ راسته دوز جک : چرخ راسته‌دوز جک 
کیف کوله پشتی : کیف کوله‌پشتی 
پرده اشپزخانه : پرده آشپزخانه 
استیکر لپ تاپ : استیکر لپ‌تاپ 
شیشه بالابر پراید : شیشه‌بالابر پراید 
عود ابشاری : عود آبشاری 
لباسشویی الجی : لباس‌شویی الجی 
شیایومی نوت 8 پرو : شیائومی نوت 8 پرو 
گردو پوست کاغذی : گردو پوست‌کاغذی 
عینک شنا حرفه ای : عینک شنا حرفه‌ای 
فوتبال دستی  : فوتبال‌دستی  
بشقاب پرنده : بشقاب‌پرنده 
ایرپاد شیائومی : ایر پاد شیائومی 
ویالون : ویالن 
لب تاب سامسونگ : لپ‌تاپ سامسونگ 
شیکر بدنسازی : شیکر بدن‌سازی 
صندلی ارایشگاه : صندلی آرایشگاه 
نوت10 : نوت 10 
چرخ خیاطی راسته دوز : چرخ خیاطی راسته‌دوز 
بند انداز برقی : بندانداز برقی 
بخاری هیزمی : بخاری‌هیزمی 
تخت خواب یک نفره دخترانه : تخت خواب یک‌نفره دخترانه 
فلز یاب : فلزیاب 
خونه : خانه 
سردنده اسپرت : سر دنده اسپرت 
ساندبار شیایومی : ساند بار شیائومی 
زمین فرفره های انفجاری : زمین فرفره‌های انفجاری 
سماور ذغالی : سماور زغالی 
اینه سرویس بهداشتی : آینه سرویس بهداشتی 
پاسماوری چینی : پا سماوری چینی 
تزیینات خودرو : تزئینات خودرو 
شیر آلات : شیرآلات 
توالت فرنگی  : توالت‌فرنگی  
دیسک وصفحه پراید : دیسک و صفحه پراید 
اویز لباس : آویز لباس 
هدفون بی سیم شیایومی : هدفون بی‌سیم شیائومی 
دچرخه اسپرت : دوچرخه اسپرت 
ساندبار سونی : ساند بار سونی 
موس بیسیم : موس بی‌سیم 
گوشی ارزان قیمت : گوشی ارزان‌قیمت 
بیسیم اسباب بازی : بی‌سیم اسباب‌بازی 
رخت آویز : رخت‌آویز 
دوچرخه افرود : دوچرخه آفرود 
لب تاپ اپل : لپ‌تاپ اپل 
ابرسان صورت : آبرسان صورت 
یخچال فریزر ال جی : یخچال‌فریزر ال جی 
موزن گوش و بینی : مو زن گوش و بینی 
برنج نیم دانه : برنج نیم‌دانه 
چاقو میوه خوری : چاقو میوه‌خوری 
سبد اسباب بازی : سبد اسباب‌بازی 
خوردکن : خورد کن 
پرسینگ فیک : پیرسینگ فیک 
شلوار شیش جیب مردانه : شلوار شش جیب مردانه 
موزاییک حیاط : موزائیک حیاط 
جنسی اقایان : جنسی آقایان 
گوشی شیایومی پوکو m3 : گوشی شیائومی پوکو m3 
چسب اکواریوم : چسب آکواریوم 
لاک پشت های نینجا : لاک پشت‌های نینجا 
کهنه شور بچه : کهنه‌شور بچه 
سبد سیب زمینی : سبد سیب‌زمینی 
پرس کابلشو : پرس کابل‌شو 
کفش ساقدار مردانه : کفش ساق دار مردانه 
خوشبو کننده هوا : خوش‌بوکننده هوا 
هندسفری بلوتوث : هندزفری بلوتوث 
دیلد خاردار : دیلدو خاردار 
دم باریک : دم‌باریک 
کرم ابرسان : کرم آبرسان 
کولر ابی 3500 : کولر آبی 3500 
دنبل بدنسازی : دمبل بدن‌سازی 
کشمش افتابی : کشمش آفتابی 
بادکنک هلیومی : بادکنک هلیوم 
ویدیو پروژکتور جیبی : ویدئو پروژکتور جیبی 
عروسک انابل : عروسک آنابل 
جا دستمال کاغذی : جا دستمال‌کاغذی 
هندزفری بی سیم سامسونگ : هندزفری بی‌سیم سامسونگ 
کتابخانه نیمه شب : کتابخانه نیمه‌شب 
ارپاد شیاومی : ایر پاد شیائومی 
کمد پارچه ای : کمد پارچه‌ای 
پیستوله رنگ پاش : پیستوله رنگ‌پاش 
افتاب گیر : آفتاب‌گیر 
دوچرخه دنده ای 26 : دوچرخه دنده‌ای 26 
دسته بکس : دسته‌بکس 
چادرمسافرتی : چادر مسافرتی 
بند انداز : بندانداز 
کالباس بر : کالباس‌بر 
موزاییک : موزائیک 
ابسردکن ایستاده : آب‌سردکن ایستاده 
ابکش استیل یونیک : آبکش استیل یونیک 
دریل سه کاره : دریل سه‌کاره 
شیر الات شودر : شیرآلات شودر 
لباسشویی بست : لباس‌شویی بست 
یخ ساز : یخ‌ساز 
کمد برزنتی : کمد برزنت‌ی 
کیف پول سخت افزاری : کیف پول سخت‌افزاری 
موتور کوچولو : موتور کوچک 
خنک کننده لپ تاپ : خنک کننده لپ‌تاپ 
کرم سفید کننده : کرم سفیدکننده 
اسپینر چراغ دار : اسپینر چراغ‌دار 
بخارشوی کارچر : بخار شوی کارچر 
سردوش حمام : سر دوش حمام 
رم لپ تاپ : رم لپ‌تاپ 
روان کننده : روان‌کننده 
میزناهارخوری : میز ناهارخوری 
گوشی هوآوی : گوشی هواوی 
سندلی گیمینگ : صندلی گیمینگ 
شلوارمردانه : شلوار مردانه 
ابرسان : آبرسان 
پرسینگ : پیرسینگ 
آبگرمکن بوتان : آب گرمکن بوتان 
دوچرخه ۲۶ دنده ای : دوچرخه ۲۶ دنده‌ای 
قلم مو : قلم‌مو 
چربی سوز : چربی‌سوز 
یخجال : یخچال 
امپر متر : آمپر متر 
لباس دروازه بانی : لباس دروازه‌بانی 
باند ماشین پایونر : باند ماشین پایونیر 
قهوه ترک : قهوه‌ترک 
ابگرمکن بوتان : آب گرمکن بوتان 
لبتاب دل : لپ‌تاپ دل 
اتو سیلتر : اتو سیل‌تر 
لوازم آرایش : لوازم‌آرایش 
دزگیر ماشین : دزدگیر ماشین 
کفش پاشنه دار : کفش پاشنه‌دار 
کاندم ژله : کاندوم ژله 
دچرخه  : دوچرخه  
ماشین کنترولی : ماشین کنترلی 
کالیمبا شیشه ای : کالیمبا شیشه‌ای 
موتور اب : موتور آب 
قاب گوشی شیایومی نوت 8 پرو : قاب گوشی شیائومی نوت 8 پرو 
پخش پایونر : پخش پایونیر 
چاقو پروانه ای : چاقو پروانه‌ای 
ردمی10 : ردمی 10 
لب تاپ گیمینگ : لپ‌تاپ گیمینگ 
دستگاه لوله بازکنی : دستگاه لوله‌بازکنی 
ظرف فریزری : ظرف فریزر 
چراق قوه : چراغ‌قوه 
اسیاب قهوه دستی : آسیاب قهوه دستی 
مبل سلطنتی 9نفره : مبل سلطنتی 9 نفره 
میز نهار خوری چهار نفره : میز نهارخوری چهار نفره 
پلی استیشن۲ : پلی استیشن ۲ 
سرپلوس پراید : سر پلوس پراید 
آ۳۲ : آ ۳۲ 
چراغ خواب  : چراغ‌خواب  
میز تی وی : میز TV 
کولر ابی پرتابل : کولر آبی پرتابل 
لب تاب استوک : لپ‌تاپ استوک 
شیامی  : شیائومی  
لپتاب گیمینگ : لپ‌تاپ گیمینگ 
اب تصفیه کن خانگی : آب تصفیه کن خانگی 
تاخیری ویگا : تأخیری ویگا 
دستگاه اکسیژن ساز : دستگاه اکسیژن‌ساز 
کیف بچه گانه : کیف بچه‌گانه 
ماشین سواری : ماشین‌سواری 
سردنده پراید : سر دنده پراید 
شیارزن : شیار زن 
لباس علی اصغر : لباس علی‌اصغر 
ماشین لباسشویی بست : ماشین لباس‌شویی بست 
ایفون12 : ایفون 12 
پینگ پنگ : پینگ‌پنگ 
سفید کننده دندان : سفیدکننده دندان 
ایپد ایر : آی پد ایر 
کولر اسپلیت 24000 : کولر اسپیلت 24000 
آبگرمکن برقی : آب گرمکن برقی 
بچه گانه : بچه‌گانه 
تخمه پوست کن : تخمه پوست‌کن 
دستگاه بستنی ساز : دستگاه بستنی‌ساز 
کفش دخترونه : کفش دخترانه 
پرسینگ گوش : پیرسینگ گوش 
دوچرخه رینگ اسپرت : دوچرخه رینگ‌اسپرت 
جاسوییچی : جا سوئیچ 
مبل تک نفره : مبل تک‌نفره 
استخربادی : استخر بادی 
موبایل شیایومی پوکو : موبایل شیائومی پوکو 
نوشابه انرژی زا : نوشابه انرژی‌زا 
کرم پودر کالیستا : کرم‌پودر کالیستا 
نوت11پرو : نوت 11 پرو 
بخارگر فیلیپس : بخار گر فیلیپس 
ایفن : آیفون 
موتورشارژی کودک : موتور شارژی کودک 
ضدافتاب درماتیپیک : ضدآفتاب درماتیپیک 
فن لپ تاپ : فن لپ‌تاپ 
روغن ترمز : روغن‌ترمز 
ابمیوه : آبمیوه 
دستگاه تاتو بدن : دستگاه تتو بدن 
روان کننده مقعدی : روان‌کننده مقعد 
قیچی ارایشگری : قیچی آرایشگری 
پاوربانک انکر : پاور بانک انکر 
تلوزیون ال ای دی : تلویزیون ال ای دی 
شیایومی 11t pro : شیائومی 11t pro 
ایر پاد شیایومی : ایر پاد شیائومی 
یخدان یونولیتی : یخدان یونولیت 
دستگاه جوجه کشی  : دستگاه جوجه‌کشی  
چاغو : چاقو 
پروتیین : پروتئین 
دوچرخه۱۶ : دوچرخه ۱۶ 
پاوربانک شیائومی : پاور بانک شیائومی 
آب پاش : آب‌پاش 
شاه نشین : شاه‌نشین 
پشه کش : پشه‌کش 
یخچال فریزر دوقلو هیمالیا : یخچال‌فریزر دوقلو هیمالیا 
اسباب بازی فرفره های انفجاری : اسباب بازی فرفره‌های انفجاری 
رخت اویز لباس : رخت‌آویز لباس 
اسباب بازی لاک پشت های نینجا : اسباب بازی لاک پشت‌های نینجا 
ست پیچ گوشتی : ست پیچ‌گوشتی 
هندفری : هندزفری 
ایرپاد ۲ : ایر پاد ۲ 
اسکیت حرفه ای : اسکیت حرفه‌ای 
یقه اسکی : یقه‌اسکی 
لپ تاب گیمینگ : لپ‌تاپ گیمینگ 
نوت 10پرو : نوت 10 پرو 
موس و کیبورد بی سیم : موس و کیبورد بی‌سیم 
پوستر دیواری سه بعدی : پوستر دیواری سه‌بعدی 
کاغذ دیواری چسب دار : کاغذ دیواری چسب‌دار 
دستگاه کارتخوان : دستگاه کارت‌خوان 
کرم پودر  : کرم‌پودر  
شیامی پوکو x3 : شیائومی پوکو x3 
سرویس چاقو اشپزخانه : سرویس چاقو آشپزخانه 
دوچرخه۱۲ : دوچرخه ۱۲ 
ایپاد : آی پاد 
فرز اهنگری : فرز آهنگری 
دست کش دروازه بانی : دست کش دروازه‌بانی 
کت وشلوار : کت و شلوار 
سرخ کن فلیپس : سرخ کن فیلیپس 
هدست بی سیم: هدست بی‌سیم
پوکا : پوکو 
کارد میوه خوری : کارد میوه‌خوری 
چراغ خطر پراید : چراغ‌خطر پراید 
صندلی ارایشگاه زنانه : صندلی آرایشگاه زنانه 
باوفنگ : بی‌سیم باوفنگ 
امپلی فایر خانگی : آمپلی‌فایر خانگی 
پیراهن استین کوتاه : پیراهن آستین‌کوتاه 
شیایومی ردمی 9 : شیائومی ردمی 9 
آیفون 13 پرومکس : آیفون 13 پرو مکس 
شیرالات راسان : شیرآلات راسان 
عینک طبی زنانه : عینک‌طبی زنانه 
اروسک : عروسک 
میلگرد 14 : میل‌گرد 14 
عینک آفتابی  : عینک‌آفتابی  
ساندبار سامسونگ : ساند بار سامسونگ 
کرم پودر لاکچری کویین : کرم‌پودر لاکچری کویین 
اتولوله : اتو لوله 
پتوشور لباسشویی : پتو شور لباس‌شویی 
استخر پیش ساخته : استخر پیش‌ساخته 
هوآوی : هواوی 
کوکوپیت : کوکو پیت 
ایفن 11 : آیفون 11 
شهاب سنگ : شهاب‌سنگ 
موزن ابرو : مو زن ابرو 
جنسینگ : جین سینگ 
ماسک سه بعدی : ماسک سه‌بعدی 
آهن ربا : آهن‌ربا 
لگو ماینکرافت : لگو ماین کرفت 
میز ارایش مدرن : میز آرایش مدرن 
روتختی یک نفره دخترانه : روتختی یک‌نفره دخترانه 
ماسک لاتکسی : ماسک لاتکس 
نیم ست : نیم‌ست 
ایرپاد پرو اپل : ایر پاد پرو اپل 
موزن : مو زن 
تک شاخ : تک‌شاخ 
آبمیوه گیری  : آبمیوه‌گیری  
لپتاپ اپل : لپ‌تاپ اپل 
امپول بیوتین بپانتین : آمپول بیوتین بپانتین 
توپ پینگ پنگ : توپ پینگ‌پنگ 
مچ بند ورزشی : مچ‌بند ورزشی 
پمپ اب پنتاکس : پمپ آب پنتاکس 
پروتیین پگاه : پروتئین پگاه 
ساق بند : ساق‌بند 
اسباب بازی دخترانه  : اسباب‌بازی دخترانه  
کاپوچینو ترابیکا : کاپوچینو تروبیکا 
هدفون شیایومی : هدفون شیائومی 
شکلات تخته ای : شکلات تخته‌ای 
پشه بند مسافرتی : پشه‌بند مسافرتی 
اسباب بازی سگهای نگهبان : اسباب‌بازی سگ‌های نگهبان 
لامپی : لامپ 
دسمال سر : دستمال سر 
ایفون کپی : آیفون کپی 
چکش تخریب پوکا : چکش تخریب پوکو 
اپلیدی فیلیپس : اپیلیدی فیلیپس 
شیایومی 12 : شیائومی 12 
اشپزخانه اسباب بازی : آشپزخانه اسباب‌بازی 
چاقو زامن دار : چاقو ضامن‌دار 
گل سر : گل‌سر 
میزعسلی : میز عسلی 
کتونی ادیداس اورجینال : کتونی آدیداس اورجینال 
۱۱تی : ۱۱ تی 
پارچ ولیوان : پارچ و لیوان 
هلدر موبایل : هولدر موبایل 
فریم عینک طبی : فریم عینک‌طبی 
بی تی اس البوم : بی تی اس آلبوم 
کله پاچه : کله‌پاچه 
زیتون پرورده : زیتون‌پرورده 
دسبند پسرانه : دستبند پسرانه 
سیمکارت : سیم‌کارت 
چرخ راسته دوز : چرخ راسته‌دوز 
تزیینی خانه : تزئینی خانه 
کاپشن مردانه ادیداس : کاپشن مردانه آدیداس 
شلوار دمپا : شلوار دم پا 
پشه بند کودک : پشه‌بند کودک 
تلویزیون شیایومی : تلویزیون شیائومی 
گاز صفحه ای استیل البرز : گاز صفحه‌ای استیل البرز 
گاز صفحه ای کن : گاز صفحه‌ای کن 
گوشی گیمینگ شیایومی : گوشی گیمینگ شیائومی 
گوشی شیامی ردمی : گوشی شیائومی ردمی 
ابزار چند کاره : ابزار چندکاره 
گوشی ارد : گوشی آرد 
تخت تک نفره : تخت تک‌نفره 
کف پوش سه بعدی : کف پوش سه‌بعدی 
پرچم محرم بزرگ چوب دار : پرچم محرم بزرگ چوب‌دار 
تخت خواب بچه گانه : تخت خواب بچه‌گانه 
دستگاه عرق گیری : دستگاه عرق‌گیری 
غذاساز کنوود : غذا ساز کنوود 
فلاکس  : فلاسک  
افتامات دینام پراید : آفتامات دینام پراید 
پوست کن : پوست‌کن 
لب تاپ سامسونگ : لپ‌تاپ سامسونگ 
آب میوه گیری : آب‌میوه‌گیری 
لگو ماین کرافت : لگو ماین کرفت 
شیامی نوت 8 پرو : شیائومی نوت 8 پرو 
هدفن گیمینگ : هدفون گیمینگ 
کلاسر : کلاسور 
ایفون6 : ایفون 6 
بیسیم اسباب : بی‌سیم اسباب 
روتختی تک نفره : روتختی تک‌نفره 
روژ لب : رژ لب 
اتوی صورت : اتو صورت 
پتو گلبافت یک نفره : پتو گلبافت یک‌نفره 
اداپتور 12 ولت : آداپتور 12 ولت 
شیاعومی : شیائومی 
نوت۱۱s : نوت ۱۱ s 
پیرینتر : پرینتر 
نودالیت : نودل 
ایفون ۱۳پرومکس : ایفون ۱۳ پرو مکس 
کفش ساقدار : کفش ساق دار 
بادکنک ارایی : بادکنک آرایی 
سفیده تخم مرغ : سفیده تخم‌مرغ 
آیفون۱۲ : آیفون ۱۲ 
اب میوه : آب‌میوه 
ساع : ساعت 
تخته نرد  : تخته‌نرد  
سرشعله : سر شعله 
ساعت هوشمند شیامی : ساعت هوشمند شیائومی 
ضد افتاب درماتیپیک : ضد آفتاب درماتیپیک 
گلدان دیواری : گلدان‌دیواری 
پاکت کرافت : پاکت کرفت 
اسباب بازی ربات : اسباب‌بازی ربات 
اب تصفیه کن : آب تصفیه کن 
شترنج : شطرنج 
مدادرنگی اریا : مدادرنگی آریا 
قرص هیر تامین : قرص هیر تأمین 
کارتخوان G2 : کارت‌خوان G2 
فنر لوله بازکنی : فنر لوله‌بازکنی 
جا مسواکی : جامسواکی 
کوات کوپتر : کواد کوپتر 
دسته دنده : دسته‌دنده 
اسباب بازی گربه : اسباب‌بازی گربه 
کفپوش سه بعدی پراید : کفپوش سه‌بعدی پراید 
الفا اسلیم : آلفا اسلیم 
تردمیل شیایومی : تردمیل شیائومی 
شیامی ردمی 9 : شیائومی ردمی 9 
اسیاب قهوه دلونگی : آسیاب قهوه دلونگی 
چیبس : چیپس 
کولر اسپلیت 30000 : کولر اسپیلت 30000 
شیامی نوت 10 پرو : شیائومی نوت 10 پرو 
پاسماوری چوبی : پا سماوری چوبی 
متور هندا : موتور هندا 
چوب پرده : چوب‌پرده 
ایکس باکس۳۶۰ : ایکس باکس ۳۶۰ 
ماشین اصلاح شیایومی : ماشین اصلاح شیائومی 
ایفون ۱۱ پرومکس : ایفون ۱۱ پرو مکس 
میزچرخ خیاطی : میز چرخ‌خیاطی 
قاشق وچنگال : قاشق و چنگال 
ویولون : ویولن 
ایفون10 : ایفون 10 
ایفون 11پرو مکس : ایفون 11 پرو مکس 
انرژی زا مانستر : انرژی‌زا مانستر 
کوله پشتی چرخ دار : کوله پشتی چرخ‌دار 
اتومات پمپ اب : اتومات پمپ آب 
تبلت دانش آموزی : تبلت دانش‌آموزی 
شلوار دمپا گشاد : شلوار دم پا گشاد 
جا کفشی فلزی : جاکفشی فلزی 
پراید کره ای : پراید کره‌ای 
کمدلباس چوبی : کمد لباس چوبی 
رورویک دلیجان : روروئک دلیجان 
ایفون سون پلاس : ایفون ۷ پلاس 
پارچه خامه دوزی : پارچه خامه‌دوزی 
اینه کنسول چوبی : آینه کنسول چوبی 
شیر الات راسان : شیرآلات راسان 
لوازم ارایشی  : لوازم آرایشی  
اب پاش : آب‌پاش 
توپ فوتبال ادیداس : توپ فوتبال آدیداس 
جا کفشی پلاستیکی : جاکفشی پلاستیکی 
گوشی سامسنگ : گوشی سامسونگ 
آبمیوه گیری پارس خزر : آبمیوه‌گیری پارس خزر 
امپیلی : آمپلی‌فایر 
کرم پودر استی لادر : کرم‌پودر استی لادر 
ابمیوه گیری صنعتی : آبمیوه گیری صنعتی 
کیلس استارت : کی لس استارت 
پرینتر28 : پرینتر 28 
مکمل بدنسازی گینر : مکمل بدن‌سازی گینر 
ابکش یونیک : آبکش یونیک 
انابل : آنابل 
دریل شارژی پی ام : دریل شارژی پی‌ام 
پیکنیک مسافرتی : پیک‌نیک مسافرتی 
سرویس ارکوپال فرانسه : سرویس آرکوپال فرانسه 
کرم پودر کوین : کرم‌پودر کوین 
سه چرخه  : سه‌چرخه  
یخچال اسباب بازی : یخچال اسباب‌بازی 
دسکش دروازه بانی : دستکش دروازه‌بانی 
ضد افتاب لدورا : ضد آفتاب لدورا 
مبل راحتی مکانیزم : مبل راحتی مکانیزه 
ارکوپال مقصود : آرکوپال مقصود 
یخچال فریزر جی پلاس : یخچال‌فریزر جی پلاس 
سنجاق سر : سنجاق‌سر 
پرینتر15 : پرینتر 15 
ساعت هوشمند  شیایومی : ساعت هوشمند شیائومی 
اسباببازی : اسباب‌بازی 
تکه هایی از یک کل منسجم : تکه‌هایی از یک کل منسجم 
قاب گوشی شیایومی پوکو : قاب گوشی شیائومی پوکو 
هدفن  : هدفون  
لباسشویی پاکشوما 9 کیلویی : لباس‌شویی پاکشوما 9 کیلویی 
ارام پز : آرام‌پز 
فرز همه کاره : فرز همه‌کاره 
المان خنک کننده : المان خنک‌کننده 
دستگاه روغن گیری : دستگاه روغن‌گیری 
مداد نوکی 0.7 : مدادنوکی 0.7 
کباب پز تابشی : کباب‌پز تابشی 
دفتر مشق حاشیه دار : دفتر مشق حاشیه‌دار 
پیچ گوشتی  : پیچ‌گوشتی  
تیشرت مردانه استین بلند : تیشرت مردانه آستین‌بلند 
میزتلفن : میز تلفن 
کتاب تکه هایی از یک کل منسجم : کتاب تکه‌هایی از یک کل منسجم 
دسته بازی کامپیوتر بی سیم : دسته بازی کامپیوتر بی‌سیم 
کارت خوان اسباب بازی : کارت خوان اسباب‌بازی 
گوشی شیاعومی : گوشی شیائومی 
بازی پلی استیشن : بازی پلی‌استیشن 
موکاپات برقی : موکا پات برقی 
اب معدنی کوچک : آب معدنی کوچک 
کیسه بوکس ادمکی : کیسه بوکس آدمک 
شامپو هد اند شولدرز : شامپو هد و شولدرز 
ابچکان استیل : آبچکان استیل 
ایفون۶ : ایفون ۶ 
موتر چهار چرخ : موتور چهار چرخ 
ساعت جیشاک : ساعت جی شاک 
ایفن 12 : آیفون 12 
پنجه بوکس  : پنجه‌بوکس  
اینورتر جوش : این‌ورتر جوش 
ردمی9 : ردمی 9 
کفشور خطی : کف شور خطی 
پروتیین بار : پروتئین بار 
کفش وزنه برداری : کفش وزنه‌برداری 
ارپاد  : ایر پاد  
ضدافتاب لدورا : ضدآفتاب لدورا 
آیفون11 : آیفون 11 
خوشبو کننده : خوش‌بوکننده 
تلویزیون ال جی  : تلویزیون ال‌جی  
اسلایم کره ای : اسلایم کره‌ای 
اتولوله کشی : اتو لوله‌کشی 
بازی فکری مونوپولی : بازی فکری مونو پولی 
اسکوتر برقی شیایومی : اسکوتر برقی شیائومی 
یو پی اس : UPS 
شیامی ردمی : شیائومی ردمی 
ایفون8 پلاس : ایفون 8 پلاس 
ماشین موزر المانی اصل : ماشین موزر آلمانی اصل 
چای سبز : چای‌سبز 
پرچم امام حسین : پرچم امام‌حسین 
اسباب بازی سگ : اسباب‌بازی سگ 
کارتخوان G3 : کارت‌خوان G3 
پکو m3 : پوکو m3 
فیلتر تصفیه اب : فیلتر تصفیه آب 
کاورمبل : کاور مبل 
غلط گیر نواری : غلط‌گیر نواری 
دریل پیچ گوشتی برقی : دریل پیچ‌گوشتی برقی 
میز تلوزیون چوبی : میز تلویزیون چوبی 
بیلی ایلیش : بیل‌ی آیلیش 
ریش تراش vgr : ریش‌تراش vgr 
کینکت : kinect 
یخچال فریزر دوقلو سامسونگ : یخچال‌فریزر دوقلو سامسونگ 
پکو ام تری : پوکو ام تری 
افتابگیر پراید : آفتاب‌گیر پراید 
ابمیوه گیری پارس : آبمیوه گیری پارس 
لوارم تحریر : لوازم تحریر 
اب میوه گیری بوش : آبمیوه گیری بوش 
اسباب بازی سگ های نگهبان : اسباب‌بازی سگ‌های نگهبان 
عینک افتابی ریبن : عینک آفتابی ریبن 
جا عودی ابشاری : جا عودی آبشاری 
جی ال ایکس : ال‌جی 
لوازم برقی اشپزخانه : لوازم برقی آشپزخانه 
مچبند هوشمند : مچ‌بند هوشمند 
دستگاه لاک خشک کن : دستگاه لاک خشک‌کن 
اجاق گاز طرح : اجاق‌گاز طرح 
تبل یاماها : طبل یاماها 
کاور گوشی شیایومی نوت 8 : کاور گوشی شیائومی نوت 8 
سشوار چرخشی بابلیس : سشوار چرخشی بابیلیس 
یخچال الکترواستیل دوقلو : یخچال الکترو استیل دوقلو 
انگشتر بچه گانه : انگشتر بچه‌گانه 
تسویه اب : تسویه آب 
موتور بچه گانه : موتور بچه‌گانه 
آهنربا : آهن‌ربا 
تختخواب یک نفره : تختخواب یک‌نفره 
اسپرسوساز صنعتی : اسپرسو ساز صنعتی 
ماکارانی : ماکارونی 
انتن هوایی : آنتن هوایی 
کولر اسپلیت گری : کولر اسپیلت گری 
دسکش بوکس : دستکش بوکس 
تیغه برف پاک کن پراید : تیغه برف‌پاک‌کن پراید 
خدکار فانتزی : خودکار فانتزی 
نوت 11پرو پلاس : نوت 11 پرو پلاس 
تیغه برف پاک کن : تیغه برف‌پاک‌کن 
هلکوپتر کنترلی : هلیکوپتر کنترلی 
ساعت عقربه ای : ساعت عقربه‌ای 
اب میوه گیر : آبمیوه‌گیری 
چراغ نفتی : چراغ‌نفتی 
فارسی بر کرون : فارسی‌بر کرون 
سشوار بابلیس : سشوار بابیلیس 
ردمی۱۰ : ردمی ۱۰ 
پازل سه بعدی : پازل سه‌بعدی 
خمیر بازی اریا : خمیر بازی آریا 
ایکس باکس360 : ایکس باکس 360 
گیاه اپارتمانی : گیاه آپارتمانی 
کره ای : کره‌ای 
جا اسکاجی : جا اسکاچ 
سماور گازی عالی نسب : سماور گازی عالی‌نسب 
موتور ساعت دیواری : موتور ساعت‌دیواری 
چمدون : چمدان 
کیسه خواب  : کیسه‌خواب  
دسته پلی استیشن ۲ : دسته پلی‌استیشن ۲ 
یخچال فریزر کلور : یخچال‌فریزر کلور 
مبل راحتی تک نفره : مبل راحتی تک‌نفره 
کرم دورچشم : کرم دور چشم 
دوچرخه12 : دوچرخه 12 
شیایومی نوت 9 پرو : شیائومی نوت 9 پرو 
خاک ژله ای : خاک ژله‌ای 
بلیارد : بیلیارد 
ریشتراش : ریش‌تراش 
مبایل شیایومی : موبایل شیائومی 
گوشی شیامی نوت : گوشی شیائومی نوت 
نوت10s : نوت 10 s 
اسپیکر قابل حمل : اسپیکر قابل‌حمل 
اسباب بازی ها : اسباب بازی‌ها 
مایکروفر ال جی : مایکروفر ال‌جی 
معجزه گر دختر کفشدوزکی : معجزه‌گر دختر کفشدوزکی 
کمد لباس برزنتی : کمد لباس برزنت‌ی 
ترکمتر هنس : ترکم‌تر هنس 
خشک کن میوه : خشک‌کن میوه 
کیسه خواب امریکایی : کیسه‌خواب امریکایی 
گوشی  هواوی : گوشی هواوی 
فرم عینک طبی : فرم عینک‌طبی 
کوزه سفالی : کوزه‌سفالی 
اس22 اولترا : اس 22 اولترا 
استوک ادیداس : استوک آدیداس 
یخچال تی سی ال : یخچال تی ال‌جی 
شیایومی 11t : شیائومی 11t 
پنل اکوستیک : پنل آکوستیک 
کمان اره : کمان‌اره 
مینی لب تاب : مینی لپ‌تاپ 
تلسکوپ دانش اموزی : تلسکوپ دانش‌آموزی 
ایفون۱۰ : ایفون ۱۰ 
گوشی ایفن 13 : گوشی آیفون 13 
گل اپارتمانی : گل آپارتمانی 
دسته موتور پراید : دسته‌موتور پراید 
ماین کرافت : ماین کرفت 
دوچرخه16 : دوچرخه 16 
ساعت عقربه ای مردانه : ساعت عقربه‌ای مردانه 
گوشی شیایومی 11lite 5g ne : گوشی شیائومی 11lite 5g ne 
مولتی متر زویی : مولتی‌متر زویی 
چوب ساب : چوب‌ساب 
ایفون12 پرو : ایفون 12 پرو 
شلوارزنانه : شلوار زنانه 
سرشور ارایشگاهی : سرشور آرایشگاهی 
جاسوییچی خودرو : جاسوئیچی خودرو 
پیش بند ارایشگری : پیش‌بند آرایشگری 
شورت اموزشی کودک : شورت آموزشی کودک 
ظرف شویی : ظرف‌شویی 
چسب دندان مصنوعی : چسب دندان‌مصنوعی 
قاب گوشی شیایومی نوت 10 : قاب گوشی شیائومی نوت 10 
فرش ۱۲متری : فرش ۱۲ متری 
تلوزیون اسنوا 50 : تلویزیون اسنوا 50 
مانتوکتی : مانتو کتی 
اسب اسباب بازی : اسب اسباب‌بازی 
گوشی پکو ام تری : گوشی پوکو ام تری 
شلواربگ : شلوار بگ 
کپسول آتش نشانی : کپسول آتش‌نشانی 
اسمارت واچ شیایومی : اسمارت واچ شیائومی 
الکترواستیل : الکترو استیل 
ام وی ام 110 : ام وی‌ام 110 
لوازم ارایشی بچه : لوازم آرایشی بچه 
 اسباب بازی :  اسباب‌بازی 
میز پینگ پونگ : میز پینگ‌پونگ 
هفت سین : هفت‌سین 
دستگاه جوراب بافی : دستگاه جوراب‌باف‌ی 
ردبول : رد بول 
نیتندو سوییچ : نیتندو سوئیچ 
شارژر باتری قلمی : شارژر باتری‌قلمی 
رو بالشتی : رو بالشت‌ی 
اسباب بازی جنسی : اسباب‌بازی جنسی 
میزناهارخوری 6نفره : میز ناهارخوری 6 نفره 
گوشی شیایومی نوت 9 پرو : گوشی شیائومی نوت 9 پرو 
ماشین لباسشویی الجی : ماشین لباس‌شویی الجی 
ست کنترل پمپ اب : ست کنترل پمپ آب 
اسباب بازی کامیون : اسباب‌بازی کامیون 
دوربین مداربسته لامپی : دوربین مداربسته لامپ 
ربع سکه : ربع‌سکه 
نگه دارنده گوشی : نگهدارنده گوشی 
لباس بدنسازی : لباس بدن‌سازی 
ابگرمکن بوتان 3115 : آب گرمکن بوتان 3115 
ایرپاد تسکو : ایر پاد تسکو 
تلوزیون دوو 55 : تلویزیون دوو 55 
اتو مخزن دار سیلتر : اتو مخزن دار سیل‌تر 
رکوردر : ضبط کن 
باند جی بی ال : باند JBL 
شیاومی نوت 8 : شیائومی نوت 8 
میز چرخ خیاطی  : میز چرخ‌خیاطی  
کرم ابرسان لدورا : کرم آبرسان لدورا 
چسب زخم : چسب‌زخم 
ابرنگ اقامیری : آبرنگ اقامیری 
گوشی شیاومی مدل تی 11 : گوشی شیائومی مدل تی 11 
لبتاب سامسونگ : لپ‌تاپ سامسونگ 
عروسک اسب تک شاخ : عروسک اسب تک‌شاخ 
سرخ کن شیایومی : سرخ کن شیائومی 
گازرومیزی : گاز رومیزی 
شلوار پارچه ای زنانه : شلوار پارچه‌ای زنانه 
ایرپاد سامسونگ اصل : ایر پاد سامسونگ اصل 
جی تی ای وی برای کامپیوتر : GTA برای کامپیوتر 
ایرپاد i12 : ایر پاد i12 
ست ادیداس : ست آدیداس 
کاور ماشین لباسشویی : کاور ماشین لباس‌شویی 
دوچرخه ۲۴ دنده ای : دوچرخه ۲۴ دنده‌ای 
ماشین شاسی بلند : ماشین شاسی‌بلند 
فرفره های انفجاری بی بلید : فرفره‌های انفجاری بی بلید 
پوکو اف ۳ : پوکو F ۳ 
جارو شارژی بلک اند : جارو شارژی blackend 
شیر اشپزخانه : شیر آشپزخانه 
شیایومی می 11 : شیائومی می 11 
اسباب بازی کارت خوان : اسباب‌بازی کارت‌خوان 
کارتخوان 7210 : کارت‌خوان 7210 
لپتاپ استوک : لپ‌تاپ استوک 
عطرمو : عطر مو 
فرفره های : فرفره‌های 
ابرنگ افرا : آبرنگ افرا 
کرم پودر گابرینی : کرم‌پودر گابرینی 
ایرپاد qcy t13 : ایر پاد qcy t13 
ماگ هیتردار : ماگ هیتر دار 
اکوستیک : آکوستیک 
فنر تفنگ بادی : فنر تفنگ‌بادی 
میوه خشک کن  : میوه خشک‌کن  
ترازو دیجیتال اشپزخانه : ترازو دیجیتال آشپزخانه 
اویز ساعت : آویز ساعت 
ارمیچر دریل : آرمیچر دریل 
پلی استیشن3 : پلی‌استیشن 3 
پودر پروتیین : پودر پروتئین 
خردکن هفت کاره : خردکن هفت‌کاره 
دوربین سیم کارتی : دوربین سیم‌کارتی 
تی شرت مشکی : تیشرت مشکی 
چای ساز دسینی : چای‌ساز دسینی 
موبل : مبل 
گوشی شیامی نوت 11 پرو : گوشی شیائومی نوت 11 پرو 
خونه سازی : خانه‌سازی 
گوشتکوب برقی بوش : گوشت‌کوب برقی بوش 
پلیستیشن : پلی‌استیشن 
ادکلن بلک افغان : ادکلن blackend افغان 
چشم بند کمپرس : چشم‌بند کمپرس 
اسبیکر بلوتوثی : اسپیکر بلوتوثی 
پمپ اب  : پمپ آب  
طبل محرم اراشی : طبل محرم آرایشی 
لاک سه قلو : لاک سه‌قلو 
ساعت  هوشمند : ساعت هوشمند 
خلال کن سیب زمینی : خلال کن سیب‌زمینی 
ادکلن لجند : ادکلن legend 
هندز فری : هندزفری 
ابنما خانگی : آبنما خانگی 
استند لوازم التحریر : استند لوازم‌التحریر 
آمپلی : آمپلی‌فایر 
اسباب بازی عروس هلندی : اسباب‌بازی عروس هلندی 
گفش مردانه : کفش مردانه 
رنگ اکرلیک : رنگ اکریلیک 
پاسماوری شیشه : پا سماوری شیشه 
دفتر حاشیه دار : دفتر حاشیه‌دار 
اسباب بازی دختر کفشدوزکی : اسباب‌بازی دختر کفشدوزکی 
سرویس اشپزخانه استیل : سرویس آشپزخانه استیل 
برف پاک کن : برف‌پاک‌کن 
پک ارایشی : پک آرایشی 
پارس اوپال : پارس اپال 
اردی : آردی 
گل بابا ادم : گل بابا آدم 
اباژور کودک : آباژور کودک 
ماشین اسباب بازی  : ماشین اسباب‌بازی  
ترک بند دوچرخه : ترک‌بند دوچرخه 
اسیاب قهوه صنعتی : آسیاب قهوه صنعتی 
پروتیین وی کاله : پروتئین وی کاله 
جای سیب زمینی پیاز : جای سیب‌زمینی پیاز 
ادامس خرسی : آدامس خرسی 
قفل حیاطی : قفل حیاط 
بلک لایت : blackend لایت 
راسته دوز جک : راسته‌دوز جک 
فرمون پراید : فرمان پراید 
کنسول قابل حمل : کنسول قابل‌حمل 
شیایومی ۱۲ : شیائومی ۱۲ 
ایفون فول کپی : آیفون کاملاً کپی 
اس ۲۲ اولترا : S ۲۲ اولترا 
ایفن ۱۱ : آیفون ۱۱ 
سوییچ پراید : سوئیچ پراید 
انگشتر اغوش : انگشتر آغوش 
پیرهن مردانه : پیراهن مردانه 
سبزی خردکن سبزایران : سبزی خردکن سبز ایران 
چای ساز برقی : چای‌ساز برقی 
دینام چرخ خیاطی : دینام چرخ‌خیاطی 
پمپ گازوییل کش : پمپ گازوئیل کش 
هنزفری  : هندزفری  
کرم سفید کننده واژن : کرم سفیدکننده واژن 
لاکژل : لاک ژل 
گاز صفحه ای داتیس : گاز صفحه‌ای داتیس 
زنگ بی سیم : زنگ بی‌سیم 
یخچال دیپونت : یخچال دیپ‌پونت 
گربه های انفجاری : گربه‌های انفجاری 
ماژیک علامت گذار : ماژیک علامت‌گذار 
ردمی۹ : ردمی ۹ 
پلی استیشن ۶ : پلی‌استیشن ۶ 
میوه خشک کن سایا : میوه خشک‌کن سایا 
کیف کارت بانکی : کیف کارت‌بانکی 
شناور اب : شناور آب 
گوشی پوکو اف تری : گوشی پوکو F 
نمک پاش : نمک‌پاش 
ایزی گلوکو : ایزی گلوکز 
ابگرمکن دیواری ایران شرق : آب گرمکن دیواری ایران شرق 
موتور جوش اینورتر : موتور جوش این‌ورتر 
مبلمان هفت نفره : مبلمان هفت‌نفره 
کتاب پاستیل های بنفش : کتاب پاستیل‌های بنفش 
استند لوازم ارایش : استند لوازم‌آرایش 
دستگاه کارت خوان : دستگاه کارت‌خوان 
دوجرخه : دوچرخه 
آرام پز : آرام‌پز 
دستگاه کارتخوان سیار : دستگاه کارت‌خوان سیار 
گوشی های شیائومی : گوشی‌های شیائومی 
بازی های ps5 : بازی‌های ps5 
چرخ خیاطی صنعتی جک : چرخ‌خیاطی صنعتی جک 
ردمی نوت ۱۱ اس : ردمی نوت ۱۱ s 
ایفون 13پرومکس : آیفون 13 پرو مکس 
نوت 11 اس : نوت 11 S 
سه راهی : سه‌راهی 
گوشی شیومی : گوشی شیائومی 
تلوزیون سامسونگ 50 : تلویزیون سامسونگ 50 
گین اپ اصل : گین آپ اصل 
کفش الستار : کفش آلستار 
مهره تخته نرد : مهره تخته‌نرد 
گوشی شیایومی نوت 11 پورو : گوشی شیائومی نوت 11 پرو 
دستگاه وکس صورت : دستگاه واکس صورت 
ابسردکن افترون : آب‌سردکن افترون 
مخزن اب پلی اتیلن : مخزن آب پلی‌اتیلن 
اسبابازی دخترانه : اسباب‌بازی دخترانه 
اتاری میکرو : آتاری میکرو 
جلومبلی وعسلی : جلو مبلی و عسلی 
پرینتر اپسون : پرینتر epson 
روغن دان : روغن‌دان 
قلم سه بعدی : قلم سه‌بعدی 
کاپشن بچه گانه : کاپشن بچه‌گانه 
لپ تاب اپل : لپ‌تاپ اپل 
فشنگی اب پراید : فشنگی آب پراید 
دستگاه وکیوم اقایان : دستگاه وکیوم آقایان 
شارژر فندکی شیایومی : شارژر فندکی شیائومی 
ذغال : زغال 
پمپ باد شیایومی : پمپ باد شیائومی 
ترولی ارایشگاه : ترولی آرایشگاه 
استندگل : استند گل 
وای فای  : وای‌فای  
دوربین اندوسکوپی : دوربین آندوسکوپی 
کفش  زنانه : کفش زنانه 
بخورسرد : بخور سرد 
ساعت هوشمند میبرو : ساعت هوشمند می‌برو 
ایفون ۱۱پرو : ایفون ۱۱ پرو 
بالم لب ابنباتی : بالم لب آب نباتی 
میزتلوزیون : میز تلویزیون 
چشم بند فانتزی : چشم‌بند فانتزی 
دوچرخه ی اسپرت : دوچرخه‌ی اسپرت 
سردوش سوبان : سر دوش سوبان 
دسته پینگ پنگ : دسته پینگ‌پنگ 
کف ساز: کف‌ساز
هارد ssd لپ تاپ : هارد ssd لپ‌تاپ 
قمقمه اب ورزشی : قمقمه آب ورزشی 
اکواریوم دلسا : آکواریوم دلسا 
جامایع ظرفشویی : جا مایع ظرفشویی 
سیرسیاه : سیر سیاه 
گوشی شیایومی پوکو x3 پرو : گوشی شیائومی پوکو x3 پرو 
اسباب بازی جدید : اسباب‌بازی جدید 
لباس پلیس بچه گانه : لباس پلیس بچه‌گانه 
دی وی ار : DVR 
فارسی بر محک : فارسی‌بر محک 
شیایومی نوت11 پرو : شیائومی نوت 11 پرو 
اسباب بازی اسباب بازی : اسباب‌بازی اسباب‌بازی 
ایرپاد هایلو w1 : ایر پاد هایلو w1 
ماینکرافت  : ماین کرفت  
تیشرت استین : تیشرت آستین 
فرش 12متری : فرش 12 متری 
پتومسافرتی : پتو مسافرتی 
ايرپاد : ایر پاد 
شارژر بی سیم : شارژر بی‌سیم 
گوشی چهار دوربینه : گوشی چهار دوربین 
ریش تراش شیایومی : ریش تراش شیائومی 
کاغذ دیواری اینه ای : کاغذ دیواری ای نه ای 
قمقمه اب کودک : قمقمه آب کودک 
دوچرخه دنده دار : دوچرخه دنده‌دار 
رئال مادرید : رئال‌مادرید 
دفتر خط دار : دفتر خط‌دار 
فرش ۶متری : فرش ۶ متری 
آیفون ۱۳پرومکس : آیفون ۱۳ پرو مکس 
نوت ۱۰پرو : نوت ۱۰ پرو 
گوشی هونور : گوشی آنر 
جعبه فیوز : جعبه‌فیوز 
تنورگازی : تنور گازی 
هود اشپزخانه اخوان : هود آشپزخانه اخوان 
اهمتر : اهم‌تر 
لباس دخترانه بچه گانه : لباس دخترانه بچه‌گانه 
بطری اب ورزشی : بطری آب ورزشی 
سیم چین کله گاوی : سیم چین کله‌گاوی 
شیر الات اهرمی : شیرآلات اهرمی 
جا حبوباتی : جا حبوبات 
عینک افتابی بچه : عینک آفتابی بچه 
اسپرسوساز بوش : اسپرسو ساز بوش 
پکیچ بوتان : پکیج بوتان 
آیفون ۱۱ پرومکس : آیفون ۱۱ پرو مکس 
ساعت  مردانه : ساعت مردانه 
کوله پشتی مدرسه ای دخترانه : کوله پشتی مدرسه‌ای دخترانه 
پاپسوکت : پاپ سوکت 
گل سر دخترانه : گل‌سر دخترانه 
اینورتر جوشکاری ادون : این‌ورتر جوشکاری ادون 
یخچال فریزر الکترو استیل : یخچال‌فریزر الکترو استیل 
کولر ابی  : کولر آبی  
لباس ادیداس : پوشاک 
متور شارژی : موتور شارژی 
بستنی ساز صنعتی : بستنی‌ساز صنعتی 
دستگاه بدنسازی خانگی : دستگاه بدن‌سازی خانگی 
شارژر 25 واتی سامسونگ : شارژر 25 وات سامسونگ 
پستونک اونت : پستانک اونت 
پودر لباسشویی پرسیل : پودر لباس‌شویی پرسیل 
رزبری پای : رزبری‌پای 
سرویس خواب تک نفره : سرویس خواب تک‌نفره 
گردنبند شب تاب : گردنبند شب‌تاب 
کیف لوازم آرایش : کیف لوازم‌آرایش 
اسکوتر برقی دسته دار : اسکوتر برقی دسته‌دار 
ایفون 11پرو : ایفون 11 پرو 
پمپ اکواریوم : پمپ آکواریوم 
نوت۱۱ پرو : نوت ۱۱ پرو 
اسباب بازی باب اسفنجی : اسباب‌بازی باب اسفنجی 
کیف کمک های اولیه : کیف کمک‌های اولیه 
اسباب بازی ماهیگیری : اسباب‌بازی ماهیگیری 
باکس اسباب بازی : باکس اسباب‌بازی 
لباسشویی پاکشوما 8 : لباس‌شویی پاکشوما 8 
مبل چستر ایتالیایی : مبل چس‌تر ایتالیایی 
لب تاپ استوک : لپ‌تاپ استوک 
مبل ال چستر : مبل ال چس‌تر 
میز بدنسازی : میز بدن‌سازی 
پرینتر135 : پرینتر 135 
اب میوه گیری پارس خزر : آبمیوه گیری پارس خزر 
رژگونه مایع : رژ گونه مایع 
اسباب بازی اژدها : اسباب‌بازی اژدها 
اسباب بازی قطار : اسباب‌بازی قطار 
اس ۲۱ : s ۲۱ 
پلی استیشن۴ : پلی استیشن ۴ 
تشک مهمان یک نفره : تشک مهمان یک‌نفره 
فیلیپس  9000 : فیلیپس 9000 
فلش64 : فلش 64 
مترلیزری : متر لیزری 
کاور لباسشویی : کاور لباس‌شویی 
دوربین سیمکارتی : دوربین سیم‌کارتی 
اجاق گاز اخوان : اجاق‌گاز اخوان 
فرتوکار اخوان : فر توکار اخوان 
ضد افتاب مای : ضد آفتاب مای 
شیامی نوت ۸ : شیائومی نوت ۸ 
مخزن : انبار 
مچ بند  : مچ‌بند  
a53 256گیگ : a53 256 گیگ 
مولتی متر ویکتور vc97 : مولتی‌متر ویکتور vc97 
شرت ورزشی : شورت ورزشی 
کنسول بازی ایکس باکس : کنسول بازی ایکس‌باکس 
اسباب بازی کودک : اسباب‌بازی کودک 
تلفن اسباب بازی : تلفن اسباب‌بازی 
گوشی شیایومی نوت ۹ : گوشی شیائومی نوت ۹ 
کاور گوشی شیایومی نوت 9 : کاور گوشی شیائومی نوت 9 
کلاه شاپو : کلاه‌شاپو 
تبلت لنووا : تبلت لنوو 
اتومسافرتی : اتو مسافرتی 
تسمه تایم ال۹۰ : تسمه تایم ال ۹۰ 
پالت سایه هدی بیوتی : پالت سایه هدی بیوت‌ی 
امپول نوروبیون : آمپول نوروبیون 
ویدیو پروژکتور شیایومی : ویدئو پروژکتور شیائومی 
ضدافتاب لافارر : ضدآفتاب لافارر 
لباسشویی پاکشوما 7 : لباس‌شویی پاکشوما 7 
کوله پشتی  مدرسه : کوله پشتی مدرسه 
کالسکه اسباب بازی : کالسکه اسباب‌بازی 
بازی فکری عمو پولدار : بازی فکری عمو پول‌دار 
سوهان برقی نیل مستر : سوهان برقی نیل مس‌تر 
سرشور ارایشگاه : سرشور آرایشگاه 
شلوار ادیداس : شلوار آدیداس 
کت شلوار پسرانه : کت‌شلوار پسرانه 
دمپایی ادیداس : دمپایی آدیداس 
دستمال توالت تنو : دستمال دستشویی تنو 
تلوزیون اسنوا 55 : تلویزیون اسنوا 55 
کیف مدرسه پسرانه شارژردار : کیف مدرسه پسرانه شارژر دار 
کوله پشتی شیایومی : کوله پشتی شیائومی 
افتاب گیر شیشه : آفتاب گیر شیشه 
اسباب بازی بچه گانه : اسباب‌بازی بچه‌گانه 
پابر بانک : پاور بانک 
انگشتر تیغ دار : انگشتر تیغ‌دار 
سماورگازی : سماور گازی 
موتور۱۲۵ : موتور ۱۲۵ 
اس۲۲ : s ۲۲ 
انگشترطلا : انگشتر طلا 
لرزه گیر ماشین لباسشویی : لرزه گیر ماشین لباس‌شویی 
اسباب بازی کنترلی : اسباب‌بازی کنترلی 
نینتندو سوییچ لایت : نینتندو سوئیچ لایت 
موتور125 : موتور 125 
پاور بانک شیایومی 10000 : پاور بانک شیائومی 10000 
شامپو لورال : شامپو اورال 
کابینت اماده : کابینت آماده 
تابلو چراغ دار : تابلو چراغ‌دار 
دمام بوشهری : ساز دمام بوشهری 
اسباب بازی موتور : اسباب‌بازی موتور 
چای ساز دلمونتی : چای‌ساز دلمونتی 
نیم تنه  : نیم‌تنه  
گوشواره بی تی اس : گوشواره بی s 
گوسی سامسونگ : گوشی سامسونگ 
ساعت سه پایه : ساعت سه‌پایه 
چراغ دیواری حیاطی : چراغ دیواری حیاط 
نوکیا105 : نوکیا 105 
ترکبند دوچرخه : ترک‌بند دوچرخه 
پلی استیشن۳ : پلی استیشن ۳ 
متر لیزری شیایومی : متر لیزری شیائومی 
کلاه افتابی دخترانه : کلاه آفتابی دخترانه 
شیایومی 11 لایت : شیائومی 11 لایت 
پلی استیشن2 : پلی استیشن 2 
شلوارلی زنانه : شلوار لی زنانه 
خط زن  : خط‌زن  
انرژی زا بلک : انرژی‌زا بلک 
ابپاش بارانی : آبپاش بارانی 
میزکامپیوتر : میز کامپیوتر 
ماست موسیر : ماست‌موسیر 
لامپ چراغ قوه : لامپ چراغ‌قوه 
هواپز دسینی : هوا پز دسینی 
کرم ابرسان صورت : کرم آبرسان صورت 
پهواد : پهپاد 
در اتاق خواب : در اتاق‌خواب 
دوچرخه فونیکس : دوچرخه فینیکس 
پی اس۴ : پی اس ۴ 
کفش اسپرت بچه گانه : کفش اسپرت بچه‌گانه 
فرکننده مو : فر کننده مو 
رنگ مو بدون امونیاک : رنگ مو بدون آمونیاک 
قوری شیشه ای : قوری شیشه‌ای 
اداپتور : آداپتور 
هلدر : هولدر 
تبلت لنوا : تبلت لنوو 
لوازم تهریر : لوازم تحریر 
توالت : دستشویی 
می بند ۷ پرو : می‌بند ۷ پرو 
گوشی شیامی نوت ۹ : گوشی شیائومی نوت ۹ 
ایرپاد شیامی : ایر پاد شیائومی 
کیف دخترونه : کیف دخترانه 
نت۱۱ : نت ۱۱ 
کفش زنانه پاشنه بلند : کفش زنانه پاشنه‌بلند 
کفش لژدار : کفش لژ دار 
چادر عربی نگین دار : چادر عربی نگین‌دار 
فلش۶۴ : فلش ۶۴ 
میزوصندلی ناهارخوری : میز و صندلی ناهارخوری 
جامداد : جا مداد 
میزکنسول : میز کنسول 
کت وشلوار زنانه مجلسی : کت و شلوار زنانه مجلسی 
مانتواداری : مانتو اداری 
لاستیک رودستون 205 : لاستیک roadstone 205 
پایه لپ تاپ : پایه لپ‌تاپ 
ایرپاد پرو اصل : ایر پاد پرو اصل 
لوازم ورزشی بدنسازی : لوازم ورزشی بدن‌سازی 
ماینر اتریوم : ماینر Ethereum 
تلوزیون 32 اینچ : تلویزیون 32 اینچ 
اس ام دی : SMD 
دوچرخه سایز 20 دنده ای : دوچرخه سایز 20 دنده‌ای 
یخچال فریزر بست : یخچال‌فریزر بست 
قلف دوچرخه : قفل دوچرخه 
لباس ادیداس پسرانه : لباس آدیداس پسرانه 
اینه و کنسول : آینه و کنسول 
گوشی ام ۳۲ : گوشی‌ام ۳۲ 
تلوزیون 50 اینچ : تلویزیون 50 اینچ 
تاچ ال سی دی : تاچ LCD 
اکسسوری مردانه : لوازم مردانه 
تیبا۲ : تیبا ۲ 
سردنده 206 : سر دنده 206 
ارام بند درب : آرام‌بند درب 
موکاپات استیل : موکا پات استیل 
پلی کربنات : پلی‌کربنات 
پیش بند : پیش‌بند 
پروژکتور  : نورافکن  
اسباب بازی اسب : اسباب‌بازی اسب 
لوازم ارایشی کیوت : لوازم آرایشی کیوت 
افتابه پلاستیکی : آفتابه پلاستیکی 
شیائومی ۱۱ تی : شیائومی ۱۱ GT 
کیف  دخترانه : کیف دخترانه 
فرتوکار التون : فر توکار التون 
میبرو : می‌برو 
رادیات پراید : رادیاتور پراید 
روغن نباتی : روغن‌نباتی 
میدرنج کیو اس : میدرنج QS 
دسته بازی ایکس باکس : دسته بازی ایکس‌باکس 
اچار رینگی : آچار رینگی 
کرم پودر نوت : کرم‌پودر نوت 
موتور اب دیزلی : موتور آب دیزلی 
پرتافیلتر : پرتو فیلتر 
آرام بند : آرام‌بند 
ناخون : ناخن 
قبله نما : قبله‌نما 
هتفون گیمینگ : هدفون گیمینگ 
اسبیکر کوچک : اسپیکر کوچک 
پلی استیشن4 : پلی استیشن 4 
لگو کاپیتان امریکا : لگو کاپیتان آمریکا 
لپ تاپ ایسوس گیمینگ : لپ‌تاپ ایسوس گیمینگ 
لپتاب اپل : لپ‌تاپ اپل 
ال ارژنین : ال آرژنین 
کیف ارایش : کیف آرایش 
درمااف : درما اف 
نوت۱۱اس : نوت ۱۱ s 
سس تک نفره : سس تک‌نفره 
جاکفشی داشبوردی : جاکفشی داشبورد 
هنذفری سیمی : هندزفری سیمی 
نوت11پرو پلاس : نوت 11 پرو پلاس 
کفکش 12 : کف کش 12 
بنسای : بن سای 
همزن کاسه ای : همزن کاسه‌ای 
ردمی نوت 11پرو : ردمی نوت 11 پرو 
کفش لژدار زنانه : کفش لژ دار زنانه 
تفنگ ابپاش : تفنگ آبپاش 
اسباب بازی نیسان : اسباب‌بازی نیسان 
نی انبان : نی‌انبان 
هندزفری شیایومی xiaomi : هندزفری شیائومی xiaomi 
لبتاپ لنوو : لپ‌تاپ لنوو 
قفسه کتاب فلزی : گنجه کتاب فلزی 
گوشب شیایومی : گوشی شیائومی 
کلمن شیشه ای شیردار : کلمن شیشه‌ای شیردار 
ماشین اصلاح بابلیس : ماشین اصلاح بابیلیس 
لوازم خانگی  : لوازم‌خانگی  
هندزفری بی سیم شیایومی : هندزفری بی سیم شیائومی 
گردنبد مردانه : گردنبند مردانه 
فریزر الکترواستیل : فریزر الکترو استیل 
هدفن بلوتوث : هدفون بلوتوث 
هسته گیر البالو : هسته گیر آلبالو 
اکتان بوستر : اکتان بوس‌تر 
لایه بردار : لایه‌بردار 
گوشی شیایومی 11t pro : گوشی شیائومی 11t pro 
گوشی شیایومی نوت 8 پرو 128 : گوشی شیائومی نوت 8 پرو 128 
ایفون۱۴ : ایفون ۱۴ 
کرم پودر هدی بیوتی : کرم‌پودر هدی بیوت‌ی 
شیامی 11 تی : شیائومی 11 GT 
دچرخه دخترانه : دوچرخه دخترانه 
بیزرا : بیز را 
اپارتمان اجاره : آپارتمان اجاره 
هود اشپزخانه بیمکث : هود آشپزخانه بی مکث 
جا سیب زمینی : جا سیب‌زمینی 
برس حرارتی پرومکس : برس حرارتی پرو مکس 
قاب گوشی شیایومی ردمی 9 : قاب گوشی شیائومی ردمی 9 
تلویزیون تی سی ال 55 : تلویزیون GT سی ال 55 
ماشین اصلاح بدن اقایان : ماشین اصلاح بدن آقایان 
پرینتر107 : پرینتر 107 
فلاکس چای استیل : فلاسک چای استیل 
دوچرخه  برقی : دوچرخه برقی 
امپیلی فایر خودرو : آمپلی‌فایر خودرو 
ماسک ورقه ای بیواکوا : ماسک ورقه‌ای بیواکوا 
ماشین صورت تراشی : ماشین صورت‌تراشی 
یخچال فریزر دوقلو الکترواستیل : یخچال‌فریزر دوقلو الکترو استیل 
سیمان سفید : سیمان‌سفید 
ضدافتاب رنگی : ضدآفتاب رنگی 
گوشی شیایومی poco x3 pro : گوشی شیائومی poco x3 pro 
لگو سیتی : لگو شهر 
قالیچه اشپزخانه : قالیچه آشپزخانه 
ایفون 13 پرومکس 256 : ایفون 13 پرو مکس 256 
روان نویس نوک نمدی : روان نویس نوک‌نمدی 
چراغ خطر دوچرخه : چراغ‌خطر دوچرخه 
ابمیوه گیری  : آبمیوه‌گیری  
کیف مدرسه ای دخترانه : کیف مدرسه‌ای دخترانه 
فلاکس مسافرتی : فلاسک مسافرتی 
تورچ ارگون : تورچ آرگون 
ردمی10c : ردمی 10 c 
کفش اسکیت بچه گانه : کفش اسکیت بچه‌گانه 
ماشین بی ام و : ماشین بی‌ام و 
دستگاه بدنسازی چندکاره : دستگاه بدن‌سازی چندکاره 
پروتیین مو : پروتئین مو 
سرشعله کوهنوردی : سر شعله کوهنوردی 
شیامی ۱۲ : شیائومی ۱۲ 
کفش کوه نوردی : کفش کوه‌نوردی 
مانیتور پشت سری : مانیتور پشت‌سری 
اسپکر : اسپیکر 
هارداکسترنال : هارد اکسترنال 
تخت اویز : تخت آویز 
چادور مسافرتی : چادر مسافرتی 
گوشی ویفون : گوشی آیفون 
خوشبو کننده دهان : خوش‌بو کننده دهان 
اسپیلیت : اسپیلت 
دستمال کاغذی  : دستمال‌کاغذی  
آبنبات : آب‌نبات 
جاسیب زمینی پیاز : جا سیب زمینی پیاز 
کمد برزنتی لباس : کمد برزنت‌ی لباس 
نان پز : نان‌پز 
فرش اشپزخانه جدید : فرش آشپزخانه جدید 
استند لپ تاپ : استند لپ‌تاپ 
قاب گوشی شیایومی نوت 10 پرو : قاب گوشی شیائومی نوت 10 پرو 
تیراهن : تیرآهن 
گوشی  اپل : گوشی اپل 
خوشبوکننده ایفل : خوش‌بوکننده ایفل 
تلوزیون ال : تلویزیون ال 
موبایل شیامی : موبایل شیائومی 
گوشی شیایومی نوت11 پرو : گوشی شیائومی نوت 11 پرو 
پرژکتور خورشیدی : پروژکتور خورشیدی 
لپ تاپ مایکروسافت : لپ‌تاپ مایکروسافت 
دوربین وای فای : دوربین وای‌فای 
موبایل شیایومی نوت 9 : موبایل شیائومی نوت 9 
ساعت  زنانه : ساعت زنانه 
ارژنین : آرژنین 
قالب شمع سازی : قالب شمع‌سازی 
ناخن مصنوعی ژله ای : ناخن مصنوعی ژله‌ای 
گلاب پاش : گلاب‌پاش 
اجاق گاز آلتون : اجاق‌گاز التون 
البوم عکس : آلبوم عکس 
لبتاب hp : لپ‌تاپ hp 
امپلی فایر مونو : آمپلی‌فایر مونو 
پشم چین : پشم‌چین 
جارو شارژی شیایومی : جارو شارژی شیائومی 
اسب سواری : اسب‌سواری 
مبل هفت نفره : مبل هفت‌نفره 
تلوزیون 55 اینچ : تلویزیون 55 اینچ 
ریلمی جی تی : ریلمی GT 
فارسی بر بوش : فارسی‌بر بوش 
نوت۱۰پرو : نوت ۱۰ پرو 
اینه بغل 206 : آینه‌بغل 206 
ایفون14 : ایفون 14 
اسپیکر بلوتوثی شیایومی : اسپیکر بلوتوثی شیائومی 
لپتاب لنوو : لپ‌تاپ لنوو 
بند ساعت شیایومی : بند ساعت شیائومی 
قفسه  : گنجه  
شیامی می 11 : شیائومی می 11 
کمک فنر جلو : کمک‌فنر جلو 
اهنربا : آهن‌ربا 
کاور شستشوی کولر : کاور شست شوی کولر 
کتونی بچه گانه دخترانه : کتونی بچه‌گانه دخترانه 
پنکک لاکچری کوین : پنکیک لاکچری کوین 
سایه چشم هدی بیوتی : سایه چشم هدی بیوت‌ی 
اکواریوم کوچک : آکواریوم کوچک 
کنتاکتور هیوندای : کنداکتور هیوندای 
گردن بند پسرانه : گردن‌بند پسرانه 
اپل۱۳ : اپل ۱۳ 
پوکوx4پرو : پوکوx 4 پرو 
ایفون 13 نات اکتیو : آیفون ۱۳ 
دوچرخه دوخترانه : دوچرخه دخترانه 
شیشه فلاکس : شیشه فلاسک 
آفتابگیر : آفتاب‌گیر 
چراق : چراغ 
کولرابی : کولرآبی 
کفکش توان : کف کش توان 
شیایومی 12 پرو : شیائومی 12 پرو 
دامن شلواری : دامن‌شلواری 
تخته نرد چوبی : تخته‌نرد چوبی 
لایه بردار صورت : لایه‌بردار صورت 
قاب گوشی بی تی اس : قاب گوشی BTS 
دیزل ژنراتور : دیزل‌ژنراتور 
مینی لب تاپ : مینی لپ‌تاپ 
وسایل برقی اشپزخانه : وسایل برقی آشپزخانه 
میکروفون اسباب بازی : میکروفون اسباب‌بازی 
اویز ماشین : آویز ماشین 
گوشی آ۲۳ : گوشی آ ۲۳ 
تلوزیون دوو 50 : تلویزیون دوو 50 
اسباب بازی ماشین سنگین : اسباب‌بازی ماشین سنگین 
ساعت هوشمند سیمکارت خور : ساعت هوشمند سیم‌کارت خور 
فیگور بی تی اس : فیگور BTS 
ایفون ۱۱  : آیفون ۱۱ 
ادامس فایو : آدامس فایو 
ضد افتاب لانسون : ضد آفتاب لانسون 
ساعت بچه گانه دخترانه : ساعت بچه‌گانه دخترانه 
ماشین ریش تراشی : ماشین ریش‌تراشی 
لب تاب ایسر : لپ‌تاپ ایسر 
تانکر اب گالوانیزه : تانکر آب گالوانیزه 
گوشی نکیا ساده : گوشی نوکیا ساده 
چای ساز کرکماز : چای‌ساز کرکماز 
کاور لباس شویی : کاور لباس‌شویی 
